{
  "1": "성실성",
  "2": "개방성",
  "3": "외향성",
  "4": "우호성",
  "5": "개방성",
  "6": "성실성",
  "7": "외향성",
  "8": "우호성",
  "9": "성실성",
  "10": "외향성",
  "11": "개방성",
  "12": "우호성"
}
